F                                                            f                                     I
HF                                     l                                                           I
AHF                 o                 EBBF       I   h             I      e  b   III               I
AAHF                          EBBBBBBBGAAD                                  III                    I
AAAHF                        EGAAAAAAAAAAD               II           III             I          * I
AAAAHBBBBBBBBBBBBBBBBBBBBBBBBGAAAAAAAAAAAHBBBBBBBBBB   II  II    III                      I   I  III
