F                                                            f                                     I
HF                                     l                                                           I
AHF                  gg               EBBF       I   h             I      e  b   III               I
AAHF                          EBBBBBBBGAAD                                  III                    I
AAAHF        p               EGAAAAAAAAAAD               II           III             I          * I
AAAAHBBBBBBBBBBBBBBBBBBBBBBBBGAAAAAAAAAAAHBBBBBBBBBB   II  II    III                      I   I  III
